accede	agree to a demand, request, or treaty, assume an office or position	同意(请求, 建议等), 就任, 就职
accessibility	quality of being able to be reached, or entered, easy to use, obtain, understood, or appreciated  	可达(及)性, 可(易)接近性, 可访问性
adrenaline	a hormone in stress, increasing rates of blood circulation, breathing, preparing muscles for exertion	肾上腺素
angle	a particular way of approaching or considering an issue or problem	观点
apprehension	anxiety or fear that something bad or unpleasant will happen, understanding, grasp	忧虑, 担心, 领悟, 恐惧, 逮捕
attune	make receptive, aware,  accustom, acclimatize, harmonious	使协调, 使合拍, 调音
belie	fail to give a true notion or impression of (something), disguise or contradict	掩饰, 遮掩, 假象
belligerent	hostile, aggressive, engaged in war or conflict	好战, 好斗, 交战, 挑衅, 寻衅
bureaucracy	government that decisions are made by state officials rather than by elected representatives, excessive administrative procedure	官僚
cynical	believing that people are motivated by self-interest; distrustful of human sincerity or integrity	愤世嫉俗
diffidence	modesty or shyness resulting from a lack of self-confidence	不自信
disinterested	not influenced by considerations of personal advantage	廉洁, 无私
disquieting	inducing feelings of anxiety or worry	令人不安
ecology	branch of biology that deals with the relations of organisms to one another and to their physical surroundings	社会生态
egalitarian	all people are equal and deserve equal rights and opportunities	平等主义
endocrine	glands which secrete hormones or other products directly into the blood	内分泌
endorse	declare one's public approval or support of	赞同, 支持, 认可
fixation	obsessive interest in or feeling about someone or something, firm, stable, concentration	异常依恋, 固定
frivolity	lack of seriousness, lightheartedness	可笑表现, 轻浮举止, 愚蠢行为
gland	an organ in which secretes particular chemical substances for use in the body or for discharge into the surroundings	腺
iconoclastic	attack on cherished beliefs or institutions	反传统, 批评传统信仰
imperious	assuming power or authority without justification, arrogant, domineering	专横, 蛮横, 盛气凌人
impetuous	acting or done quickly and without thought or care, moving forcefully or rapidly	浮躁, 急躁
injudicious	poor judgment, unwise	不明智, 不当
interplay	way in which two or more things have an effect on each other	相互作用, 影响
intractable	hard to control or deal with, difficult or stubborn	棘手, 难对付
judicious	good judgment or sense	明智, 明断, 有见地, 恰如其份
keen	having or showing great perception or insight, sharp, penetrating, clear	敏锐, 锋利
norepinephrine	a hormone that is released by the sympathetic nerves and functions as a neurotransmitter, also used as a drug to raise blood pressure	肾上腺素
overshadow	tower above and cast a shadow over, appear much more successful, impressive, prominent, or important than	使显得逊色, 掩盖, 遮蔽, 黯然失色, 扫兴, 蒙上阴影
patent	a government authority or license conferring a right or title, sole right to exclude others from making, using, or selling an invention	专利
pellucid	translucently (半透明) clear, lucid (表达清楚) in style or meaning, easily understood	透明, 清澈, 清晰
prodigal	spending money or resources freely and recklessly, wastefully extravagant	浪费, 挥霍, 大手大脚
prolix	(of speech or writing) using or containing too many words, tediously lengthy	冗长, 说话啰嗦的
secrete	(of a cell, gland, or organ) produce and discharge (a substance)	分泌
snap	break suddenly and completely with a sharp cracking sound, make a sudden audible (听得见) bite	断裂, 咬
sparing	moderate, economical	慎用, 俭省, 吝惜
synchronize	occur or operate at the same time or rate, concurrent execution of threads that share critical resources	同步
tract	a major passage in the body, large bundle of nerve fibers, or other continuous elongated anatomical structure or region	(连通身体组织或器官的)道
unsparing	merciless, severe, given freely and generously	无情, 严厉, 慷慨, 大方, 不吝啬
vigorous	strong, healthy, full of energy, forceful	充满活力, 精力充沛, 强健
voluble	talking fluently, readily, or incessantly, (of speech) characterized by fluency and readiness of utterance	滔滔不绝, 健谈, 流利, 明快
wary	caution about possible dangers or problems	小心, 谨慎
